....X.X..X.X....
X.XX..X.X.......
..X..X...X.X...X
.X.XXXX...X.....
...X.XX.XXXXX..X
.X...........XXX
...X.X....X.X...
...X....X...XX..
.XX.XX.....X.XX.
...X.....XXX.X.X
....X..XX.b.....
....X....X.XX..X
...X..X....X.X..
a....XXX..XX...X
.XX..X......X...
.X...X...XX.X...
