XXX...X.......XX
...X.XX...XX....
.....XX......X.X
...X....X....X.X
.X....X.......XX
..X.......X.XX.X
X.XX..XX.X.X.X..
..X...X....X...X
X..XX.....XXXXXX
.X.........X....
......X.X..X.XX.
.X...XX...X.X...
....X...XX......
bX..........X.XX
X.XX..X.....XX..
X..X.a...XX...X.
