E E E E E E E E E E E E E E E E E E E E E E E E E E E E E E E E
E 0 A A A A A A A A A A A A A A A A A A A 5 A A A A A A A A A E
E A A A A A 3 A A A A A A A A A A A A A E E E A A A A A A A A E
E E F E F E E F F E E E E E A A A A A E E E E E E E A A A A A E
E F F F F F F F F F F F F E E E A E E E E E W W W W W W W W W E
E F F F F F F F F F F F F F F F F E E E E E W W W W W W W W W E
E F F F F F F F F F F F E E E E E E E W W W W W W W W W W W W E
E F F F F F F F E E E E E E E E E E W W W W W W W W W W W W W E
E F F F F F F F E E E E E E E E E E E W W W W W W W W W W W W E
E E E E E 1 A A E E E E E E E E E E E W W W W W W W W W W W W E
E E E E E E A A A E E E E E E E E E E E W W W W W W W W W W W E
E E E E E E A A E E E E E E E W W W W W W W W W W W W W W W W E
E E E E E E A A E E E E E E E W W W W W W W W W W W W W W W W E
E E E 4 E E A A E E E E E E E E E E E A A A A A A A A A A A A E
E A A A A A A A A A A E E E E E E E E E A A A A A A A A A A A E
E A A E A E A A A F F F F F F F F F F F F F F F F F F F F F 2 E
E F F F F E E E E E E E F F F F F F F F F F F F F F F F F E E E
E E E E E E E E E E E E E E E E E E E E E E E E E E E E E E E E